┌──────────────────────────────────────────────────┐
│                                                  │
│                                                  │
│                                                  │
│                                                  │
│                                                  │
│                                                  │
│                                                  │
│                                                  │
│                                                  D
│                                                  D
│                                                  D
│                                                  │
│                                                  │
│                                                  │
│      X                                           │
│                                                  │
│                                                  │
│                                                  │
│                                                  │
└──────────────────────────────────────────────────┘
