┌──────────────────────────────────────────────────┬──────────────────────────────────────────────┐
│                                                  │                                              │
│                                                  │                                         G    ┴
│                                    O             │                                              X
│                                    O             │                                              X
│                                                  │                                              ┬
│                                                  │                                              │
│                                                  │                                              │
│                                                  │                                              │
│                                                  │                                              │
│                                                  │                                              │
│                                                  ┴                                              │
│                                                  X                                              │
│                                                  X                                              │
│                                                  ┬                                              │
│                                                  │                                              │
│                                                  │                                              │
│                                                  │                                              │
│                                                  │                                              │
│                                                  │                                              │
│                                                  │                                              │
│      X                                           │                                              │
│                                                  │                                              │
│                                                  │                                              │
│──────────────────────┤XXX├───────────────────────┼──────────────┤XXX├───────────────────────────┤
│                                                  │                                              │
│      O                                           │                                              │
│                                                  │     O                                        │
│                                                  │                                              │
│                                                  │                                              │
│                                                  │                                              │
│                                                  │                                              │
│                                                  │                                              │
│                                                  ┴                                              │
│                                                  X                                              │
│                                                  X                                              │
│                                                  ┬                                              │
│                                                  │                                              │
│                                                  │                                              │
│                                                  │                                              │
│                                                  │                                              │
│                                                  │                                              │
│                                                  │                                              │
│                                     O            │                                      X       │
│                                                  │                                              │
│                                                  │                                              │
└──────────────────────────────────────────────────┴──────────────────────────────────────────────┘
